border_size=1
usage=map

Xu          , Xu          , Xu          , Xu          , Xu          , Xu          , Xu          , Xu          , Xu          , Xu          , Xu          , Xu          , Xu          , Xu          , Xu          , Xu          , Xu          , Xu          , Xu          , Xu          , Xu          , Xu          
Xu          , Xu          , Xu          , Xu          , Xu          , Xu          , Xu          , Xu          , Xu          , Xu          , Rr          , Rr          , Rr          , Xu          , Uh          , Xu          , Xu          , Xu          , Xu          , Xu          , Xu          , Xu          
Xu          , Xu          , Xu          , Xu          , Xu          , Uh          , Re          , Uu^Uf       , Uu^Uf       , Uu          , Uu          , Rr          , Uu          , Uu          , Uh          , Uh          , Re          , Uh          , Xu          , Xu          , Xu          , Xu          
Xu          , Xu          , Xu          , Xu          , Ds          , Ds          , Ds          , Re          , Re          , Uu          , Uu          , Uu          , Uh          , Uh          , Uu          , Re          , Ds^Dr       , Ds          , Ds          , Xu          , Xu          , Xu          
Xu          , Xu          , Xu          , Ds          , Ds          , Ds          , Ds^Dr       , Ds          , Ds          , Re          , Re          , Uu          , Uu          , Uu          , Uu          , Re          , Re          , Ds          , Ds          , Xu          , Xu          , Xu          
Xu          , Xu          , Xu          , Ds          , Ds          , Ds          , Re          , Ds          , Ds          , Re          , Ur          , Ur          , Ur          , Uu          , Uu          , Uu          , Re          , Ds          , Re          , Xu          , Xu          , Xu          
Xu          , Xu          , Xu          , Re          , Re          , Re          , Ur          , Ds          , Rd          , Rd          , Ds          , Re          , Uu          , Uu          , Uh          , Uu          , Xu          , Re          , Uh          , Xu          , Xu          , Xu          
Xu          , Xu          , Xu          , Uu          , Uu          , Uu          , Ur          , Ur          , Re          , Ds          , Uu          , Uh          , Uh          , Re          , Re          , Uh          , Uh          , Xu          , Xu          , Xu          , Xu          , Xu          
Xu          , Xu          , Xu          , Xu          , Uu          , Uu          , Uh          , Ur          , Ur          , Uu          , Uu          , Uh          , Xu          , Ds          , Ds          , Re          , Uu          , Uh          , Uh          , Xu          , Xu          , Xu          
Xu          , Xu          , Ww          , Uu          , Uu          , Uh          , Uh          , Uu          , Uu          , Ur          , Uu^Vu       , Xu          , Xu          , Xu          , Ds          , Re          , Uu          , Uh          , Xu          , Xu          , Xu          , Xu          
Xu          , Xu          , Ww^Vm       , Ww          , Ww          , Uu          , Uu          , Uu          , Uu^Uf       , Uu          , Ur          , Ds          , Ds          , Xu          , Ds^Dr       , Re          , Re          , Uu          , Uh          , Xu          , Xu          , Xu          
Xu          , Ww          , Ww          , Ww          , Uu          , Xu          , Uu          , Uu^Uf       , Uu^Uf       , Uu          , Ur          , Re          , Re          , Ds          , Re          , Ds          , Ds          , Re          , Uu          , Uh          , Uh          , Xu          
Xu          , Xu          , Xu          , Uu          , Xu          , Uu          , Uu          , Uh          , Uu          , Uu          , Ur          , Ur          , Ur          , Re          , Uu          , Re          , Re          , Re          , Uu          , Uh          , Uh          , Xu          
Xu          , Xu          , Xu          , Xu          , Xu          , Uh          , Uu          , Uu          , Uu          , Uu          , Ur          , Uu          , Uu          , Ur          , Ur          , Uu          , Uu          , Uu          , Uu          , Uu          , Xu          , Xu          
Xu          , Xu          , Xu          , Xu          , Xu          , Uh          , Uu          , Uu^Dr       , Ur          , Ur          , Re          , Re          , Re          , Uu          , Uu          , Uu          , Uu          , Xu          , Xu          , Xu          , Xu          , Xu          
Xu          , Xu          , Xu          , Xu          , Uh          , Uu          , Uu          , Uu          , Uu          , Uu          , Re          , Ds          , Ds          , Re          , Re          , Uu          , Uu          , Xu          , Xu          , Xu          , Xu          , Xu          
Xu          , Xu          , Xu          , Uh          , Uh          , Uu          , Uh          , Uh          , Uu          , Uu          , Uu          , Re          , Ds^Dr       , Ds          , Ds          , Re          , Re          , Uu          , Uu          , Xu          , Xu          , Xu          
Xu          , Xu          , Xu          , Uh          , Uu          , Uu          , Uu          , Uh          , Uu          , Uu^Uf       , Uu^Uf       , Re          , Re          , Ds          , Ds          , Ds          , Ds          , Re          , Re          , Xu          , Xu          , Xu          
Xu          , Xu          , Uh          , Uu          , Uu          , Uu^Uf       , Uu^Uf       , Uu          , Uh          , Uu^Uf       , Uu          , Uu          , Uu          , Re          , Ds          , 1 Dd^Dc     , Ds          , Ds          , Xu          , Xu          , Xu          , Xu          
Xu          , Xu          , Uh          , Uu          , Uu          , Uu^Uf       , Uh          , Uh          , Uh          , Uu          , Uu          , Uu          , Rr          , Re          , Ds          , Ds          , Xu          , Xu          , Xu          , Xu          , Xu          , Xu          
Xu          , Xu          , Xu          , Uh          , Xu          , Xu          , Xu          , Xu          , Xu          , Uh          , Xu          , Rr          , Rr          , Rr          , Xu          , Xu          , Xu          , Xu          , Xu          , Xu          , Xu          , Xu          
Xu          , Xu          , Xu          , Xu          , Xu          , Xu          , Xu          , Xu          , Xu          , Xu          , Xu          , Xu          , Xu          , Xu          , Xu          , Xu          , Xu          , Xu          , Xu          , Xu          , Xu          , Xu          
