border_size=1
usage=map

Aa          , Ha          , Ha          , Ha          , Ha          , Ms          , Ms          , Ms          , Ha          , Ha          , Ha          , Ha          , Ha          , Ha          , Ha          , Ha          , Ha          , Ha          , Ha          , Ha          , Ha          , Ha          , Ha          , Ha          , Ms          , Ms          , Ms          , Ms          , Ms          , Ms          , Ms          , Ms          , Ms          , Ms          , Ms          , Ms          , Ha          
Aa          , Ha          , Ha          , Ha          , Ha          , Ha          , Ha          , Ha          , Ha          , Ha          , Ha          , Ha          , Ha          , Ha          , Aa          , Aa          , Aa          , Aa          , Aa          , Ha          , Ha          , Ha          , Ha          , Ha          , Ha          , Ha          , Ha          , Ha          , Ha          , Ha          , Aa          , Aa^Fpa      , Aa^Fpa      , Aa^Fpa      , Aa^Fpa      , Ha          , Ha          
Aa          , Aa          , Aa^Vca      , Aa^Fpa      , Aa^Fpa      , Aa^Fpa      , Aa^Fpa      , Aa          , Aa          , Aa          , Re^Gvs      , Re^Gvs      , Re^Gvs      , Aa          , Gg          , Gg          , Re^Gvs      , Ggf         , Ggf         , Aa          , Aa^Fpa      , Aa^Fpa      , Aa^Fpa      , Aa^Fpa      , Aa^Fpa      , Aa^Fpa      , Gg          , Re^Gvs      , Re^Gvs      , Re^Gvs      , Re^Gvs      , Gg^Vc       , Gg          , Aa          , Aa          , Aa^Fpa      , Ha          
Aa          , Aa          , Aa^Fpa      , Aa^Fpa      , Aa^Fpa      , Aa^Fpa      , Aa          , Aa          , Aa          , Aa          , Re^Gvs      , Re^Gvs      , Re^Gvs      , Gg^Vc       , Re^Gvs      , Re^Gvs      , Re^Gvs      , Re^Gvs      , Gg          , Gg          , Gg          , Aa^Fpa      , Aa^Fpa      , Aa^Fpa      , Aa^Fpa      , Aa^Fpa      , Gg          , Gg          , Gg          , Re^Gvs      , Re^Gvs      , Re^Gvs      , Gg          , Aa          , Aa          , Aa          , Ha          
Aa          , Aa^Fpa      , Aa^Fpa      , Aa^Fpa      , Aa^Fpa      , Aa^Fpa      , Aa          , Aa          , Aa          , Aa          , Gg          , Re^Gvs      , Gg          , Re^Gvs      , Re^Gvs      , Re^Gvs      , Re^Gvs      , Re^Gvs      , Gg          , Gg          , Gg          , Gg          , Gs^Fp       , Gs^Fp       , Gg          , Gg          , Uu          , Uu          , Gg          , Re^Gvs      , Re^Gvs      , Re^Gvs      , Aa          , Aa          , Aa          , Aa          , Ha          
Aa          , Aa^Fpa      , Aa^Fpa      , Aa^Fpa      , Aa^Fpa      , Aa          , Aa          , Aa          , Aa^Fpa      , Aa^Fpa      , Aa^Fpa      , Gg          , Gg          , Re^Gvs      , Re^Gvs      , Re^Gvs      , Re^Gvs      , Re^Gvs      , Uu          , Uu          , Gg          , Gg          , Gg          , Gs^Fp       , Gg          , Gg          , Gg          , Uu          , Gg          , Gg          , Aa          , Aa          , Aa          , Aa          , Aa          , Aa          , Ha          
Aa          , Aa^Fpa      , Aa^Fpa      , Aa^Fpa      , Gg          , Gg          , Gg          , Aa^Fpa      , Aa^Fpa      , Aa^Fpa      , Aa^Fpa      , Aa          , Gg          , Gg          , Re^Gvs      , Re^Gvs      , Re^Gvs      , Re^Gvs      , Uu          , Uu          , Gg          , Gg          , Ce          , Gg          , Ce          , Gg          , Ce          , Gg          , Ce          , Gg          , Ce          , Gg          , Gg          , Aa          , Aa          , Aa          , Aa          
Aa          , Aa          , Aa          , Gg          , Gg          , Gg          , Gg          , Gg          , Gg^Vc       , Aa^Fpa      , Aa          , Aa          , Gg          , Gg          , Gg^Vc       , Re^Gvs      , Re^Gvs      , Re^Gvs      , Gg          , Uu          , Gg          , Gg          , Gg          , Ce          , Gg          , Ce          , Gg          , Ce          , Re^Gvs      , Ce          , Re^Gvs      , Ce          , Ce          , Ha          , Ha          , Aa          , Aa          
Aa          , Aa          , Aa          , Gg          , Gg          , Ce          , Gg          , Gg          , Gg          , Gg          , Gg          , Gg          , Gg          , Gg          , Gg          , Re^Gvs      , Re^Gvs      , Re^Gvs      , Gg          , Gg          , Gg          , Gg          , Gg          , Gg          , Gg          , Gg          , Re^Gvs      , Re^Gvs      , Re^Gvs      , Re^Gvs      , Re^Gvs      , Re^Gvs      , Re^Gvs      , Ce          , Ha          , Ha          , Aa          
Aa          , Aa          , Aa          , Gg          , Ce          , 1 Ke        , Ce          , Gg          , Gg          , Gg          , Gg          , Gg          , Gs^Fp       , Gg          , Gg          , Gg          , Gg          , Gg          , Gg          , Gg          , Ce          , Ce          , Ce          , Gg          , Gg          , Gg          , Re^Gvs      , Re^Gvs      , Re^Gvs      , Re^Gvs      , Re^Gvs      , Re^Gvs      , Re^Gvs      , Ce          , Ha          , Ha          , Aa          
Aa          , Aa          , Aa          , Gg          , Gg          , Gg          , Gg          , Gg          , Gg          , Gg          , Gg          , Gg          , Gg          , Gg          , Gg          , Gg          , Gg          , Gg          , Gg          , Gg          , Re          , Ke          , Re          , Gg          , Gg          , Gg          , Gg          , Gs^Fp       , Re^Gvs      , Re^Gvs      , Gg          , Re^Gvs      , Re^Gvs      , Ce          , Ha          , Ha          , Ms          
Re          , Re          , Re          , Re          , Re          , Re          , Re          , Re          , Re          , Gg          , Re          , Gg          , Gg          , Gg          , Aa          , Aa          , Gg          , Gg          , Gs^Fp       , Gg          , Gg          , Re          , 2 Gg        , Gg          , Gg^Vh       , Gg          , Gg^Wm       , Gg^Vh       , Re          , Gg          , Ggf         , Gg          , Re^Gvs      , Ce          , Ha          , Ms          , Ms          
Re          , Re          , Re          , Re          , Gs          , Re          , Re          , Re          , Re          , Re          , Re          , Re          , Re          , Ggf         , Aa          , Re          , Re          , Re          , Re          , Re          , Re          , Re          , Re          , Re          , Re          , Re          , Re          , Re          , Rp          , Rp          , Gg^Fet      , Re^Gvs      , Re^Gvs      , Ce          , Ha          , Ms          , Ms          
Aa          , Aa          , Aa          , Gs          , Gs          , Gs          , Gs          , Gs^Fp       , Gs          , Gs          , Re^Gvs      , Re^Gvs      , Re^Gvs      , Re          , Re^Gvs      , Re          , Gs          , Re          , Gs          , Re          , Gs          , Re          , 3 Gs        , Re          , Gg^Vh       , Gg^Wm       , Re          , Gg^Wm       , Rp          , Gg^Ve       , Ggf         , Ggf         , Re^Gvs      , Ce          , Ce          , Ha          , Aa          
Aa          , Aa          , Aa          , Gs          , Gs          , Gs          , Gs          , Gs          , Uu          , Gs          , Re^Gvs      , Re^Gvs      , Re^Gvs      , Re^Gvs      , Re^Gvs      , Re^Gvs      , Re^Gvs      , Uu          , Gs          , Gs          , Re          , Re          , Re          , Gs          , Gs          , Gs          , Re          , Gg^Vh       , Gg          , Rp          , Re^Gvs      , Re^Gvs      , Re^Gvs      , Ce          , Aa^Fpa      , Aa^Fpa      , Aa^Fpa      
Aa          , Aa          , Aa^Fpa      , Aa          , Aa          , Gs          , Gs          , Uu          , Gs          , Gs          , Gs          , Re^Gvs      , Aa          , Aa          , Re^Gvs      , Re^Gvs      , Re^Gvs      , Re^Gvs      , Gs          , Gs          , Ce          , Ke          , Ce          , Gs          , Gs          , Gs^Fp       , Re          , Gg          , Re^Gvs      , Re^Gvs      , Re^Gvs      , Re^Gvs      , Re^Gvs      , Ce          , Aa^Fpa      , Aa^Fpa      , Aa^Fpa      
Aa          , Aa^Fpa      , Aa^Fpa      , Aa^Fpa      , Aa^Fpa      , Gs          , Gs          , Gs          , Gs          , Gs          , Gs          , Aa          , Gs          , Gg^Vc       , Re^Gvs      , Re^Gvs      , Re^Gvs      , Re^Gvs      , Re^Gvs      , Re^Gvs      , Gs          , Ce          , Re^Gvs      , Uu          , Uu          , Gs          , Re          , Gg          , Gg          , Re^Gvs      , Re^Gvs      , Re^Gvs      , Re^Gvs      , Ce          , Aa^Fpa      , Aa^Fpa      , Aa^Fpa      
Aa          , Aa^Fpa      , Aa^Fpa      , Aa^Fpa      , Aa^Fpa      , Gg^Vc       , Gs          , Gs          , Aa          , Aa          , Aa          , Aa          , Aa          , Re^Gvs      , Re^Gvs      , Re^Gvs      , Re^Gvs      , Re^Gvs      , Re^Gvs      , Re^Gvs      , Re^Gvs      , Re^Gvs      , Re^Gvs      , Uu          , Gs          , Gs          , Ww^Bw|      , Gg          , Ww          , Gg          , Gg          , Re^Gvs      , Re^Gvs      , Ce          , Aa^Fpa      , Aa^Fpa      , Aa^Fpa      
Aa          , Aa          , Aa^Fpa      , Aa^Fpa      , Aa^Fpa      , Aa^Fpa      , Aa^Fpa      , Aa^Fpa      , Aa^Fpa      , Aa          , Aa^Fpa      , Aa          , Aa          , Re^Gvs      , Re^Gvs      , Re^Gvs      , Re^Gvs      , Re^Gvs      , Re^Gvs      , Re^Gvs      , Re^Gvs      , Re^Gvs      , Re^Gvs      , Re^Gvs      , Gs          , Ww          , Ww          , Ww          , Ww          , Ww          , Gs^Fp       , Re^Gvs      , Ce          , Ce          , Aa^Fpa      , Aa^Fpa      , Aa^Fpa      
Aa          , Aa          , Aa^Fpa      , Aa^Fpa      , Aa^Fpa      , Aa^Fpa      , Aa^Fpa      , Aa^Fpa      , Aa^Fpa      , Aa^Fpa      , Aa^Fpa      , Aa^Fpa      , Aa^Fpa      , Aa          , Re^Gvs      , Re^Gvs      , Re^Gvs      , Re^Gvs      , Aa^Fpa      , Re^Gvs      , Re^Gvs      , Re^Gvs      , Gg          , Gs          , Ww          , Ww          , Ww          , Ww          , Ww          , Gs^Fp       , Aa^Fpa      , Gs^Fp       , Aa^Fpa      , Aa^Fpa      , Aa^Fpa      , Aa^Fpa      , Aa^Fpa      
Aa          , Aa          , Aa^Fpa      , Aa^Fpa      , Aa^Fpa      , Aa^Fpa      , Aa          , Aa^Fpa      , Aa^Fpa      , Aa^Fpa      , Aa^Fpa      , Aa^Fpa      , Aa^Fpa      , Aa          , Aa          , Gs^Fp       , Aa          , Aa^Fpa      , Aa^Fpa      , Aa^Fpa      , Aa^Fpa      , Gg          , Ai          , Ww          , Ai          , Ww          , Ww          , Ww          , Ww          , Ai          , Aa^Fpa      , Aa^Fpa      , Aa^Fpa      , Aa^Fpa      , Aa^Fpa      , Aa^Fpa      , Aa          
Aa          , Aa          , Aa          , Aa          , Aa          , Aa          , Aa          , Aa          , Aa          , Aa          , Aa          , Aa          , Aa          , Aa          , Aa          , Aa          , Aa          , Aa          , Aa          , Aa          , Aa          , Aa          , Aa          , Ww          , Ww          , Ww          , Ww          , Ww          , Ww          , Ww          , Ww          , Aa^Fpa      , Aa^Fpa      , Aa^Fpa      , Aa^Fpa      , Aa^Fpa      , Aa^Fpa      
